NO                             ./assets/textures/BRICK_1A_v2.xpm
SO     ./assets/textures/BRICK_2A_v2.xpm
WE ./assets/textures/BRICK_3D_v2.xpm
EA ./assets/textures/BRICK_4A_v2.xpm

F                            0,100,0
C 225,30,0


        1111111111111111111111111
        1000000000110000100000001
        1011000111110000000000001111
        10010001 10000000000000001
111111111011000111110000000000001111
100000000011000001110000111111111
11110111111111011100000010001
11110111111111011101010000001
11000000110101011100000000001
10000000000000000000000010001
10000000000000001101010010001
11000001110101011111011110N0111
11110111 1110101 101111110001
11111111 1111111 111111 11111