NO                                   ./assets/textures/BRICK_1A_v2.xpm
SO     ./assets/textures/BRICK_2A_v2.xpm
WE                ./assets/textures/BRICK_3D_v2.xpm                           
EA ./assets/textures/BRICK_4A_v2.xpm

F                           0,100,0
C 1,1,1


        1111111111111111111111111
        1000000000110000100000001
        1011000111110000000000001111
        10010001 100000000000000001
111111111011000111110000000000001111
100000000011000111110000111111111
1111001111111111 110000010001
1111001111111111 1101010000001
11000000110101011110000000001
10000000000000000000000010001111
10000000000000001101010010N01111
11000001110001011111011110001101
1111011111110101 101111110001111
1111111 11111111 111111 111111111